*****************************************************************************************************************************************************
*****************************************************************************************************************************************************
*****************************************************************************************************************************************************
*****************************************************************************************************************************************************
*****************************************************************************************************************************************************
*****************************************************************************************************************************************************
*****************************************************************************************************************************************************
*****************************************************************************************************************************************************
*****************************************************************************************************************************************************
*****************************************************************************************************************************************************
*****************************************************************************************************************************************************
*****************************************************************************************************************************************************
*****************************************************************************************************************************************************
*****************************************************************************************************************************************************
*****************************************************************************************************************************************************
*****************************************************************************************************************************************************
*****************************************************************************************************************************************************
*****************************************************************************************************************************************************
*****************************************************************************************************************************************************
*****************************************************************************************************************************************************
*****************************************************************************************************************************************************
*****************************************************************************************************************************************************
*****************************************************************************************************************************************************
*****************************************************************************************************************************************************
*****************************************************************************************************************************************************
*****************************************************************************************************************************************************
*****************************************************************************************************************************************************
*****************************************************************************************************************************************************
*****************************************************************************************************************************************************
*****************************************************************************************************************************************************
*****************************************************************************************************************************************************
*****************************************************************************************************************************************************
*****************************************************************************************************************************************************
*****************************************************************************************************************************************************
*****************************************************************************************************************************************************
*****************************************************************************************************************************************************
*****************************************************************************************************************************************************
W****************************************************************************************************************************************************
W****************************************************************************************************************************************************
W********W********************E*************************************************************T****F***T*****CF*RFF0FF*RFC*****************************
W********W*******F****************************E******************E*******************GGG*****GGGGGGGG******GGGGGGGGGGGGG*****************************
W***W****W*****FGG******************************************************F*****GGG****UUU*****UUUUUUUU******UUUUUUUUUUUUU*****************************
W***WFRFWW*****GUUG****F*****C***R*T*****T********TCRF*C*******T**C**T*GGG****UUU****UUU******UUUUUU*************************************************
UGGGGGGGGGGG***UUUUGGGGGGGGGGGGGGGG*******GGGGGGGGGGGGGGGG******GGGGG**UUU****UUU********************************************************************
UUUUUUUUUUUU***UUUUUUUUUUUUUUUUUUUU*******UUUUUUUUUUUUUUUU******UUUUU********************************************************************************
UUUUUUUUUUUU***UUUUUUUUUUUUUUUUUUUU*******UUUUUUUUUUUUUUUU******UUUUU********************************************************************************
UUUUUUUUUUUU***UUUUUUUUUUUUUUUUUUUU*******UUUUUUUUUUUUUUUU******UUUUU********************************************************************************
UUUUUUUUUUUU***UUUUUUUUUUUUUUUUUUUU*******UUUUUUUUUUUUUUUU******UUUUU********************************************************************************
UUUUUUUUUUUU***UUUUUUUUUUUUUUUUUUUU*******UUUUUUUUUUUUUUUU******UUUUU********************************************************************************
UUUUUUUUUUUU***UUUUUUUUUUUUUUUUUUUU*******UUUUUUUUUUUUUUUU******UUUUU********************************************************************************
UUUUUUUUUUUU***UUUUUUUUUUUUUUUUUUUU*******UUUUUUUUUUUUUUUU******UUUUU********************************************************************************
UUUUUUUUUUUU***UUUUUUUUUUUUUUUUUUUU*******UUUUUUUUUUUUUUUU******UUUUU********************************************************************************
UUUUUUUUUUUU***UUUUUUUUUUUUUUUUUUUU*******UUUUUUUUUUUUUUUU******UUUUU********************************************************************************