*****************************************************************************************************************************************************
*****************************************************************************************************************************************************
*****************************************************************************************************************************************************
*****************************************************************************************************************************************************
*****************************************************************************************************************************************************
*****************************************************************************************************************************************************
*****************************************************************************************************************************************************
*****************************************************************************************************************************************************
*****************************************************************************************************************************************************
*****************************************************************************************************************************************************
*****************************************************************************************************************************************************
*****************************************************************************************************************************************************
*****************************************************************************************************************************************************
*****************************************************************************************************************************************************
*****************************************************************************************************************************************************
*****************************************************************************************************************************************************
*****************************************************************************************************************************************************
*****************************************************************************************************************************************************
*****************************************************************************************************************************************************
*****************************************************************************************************************************************************
*****************************************************************************************************************************************************
*****************************************************************************************************************************************************
*****************************************************************************************************************************************************
*****************************************************************************************************************************************************
*****************************************************************************************************************************************************
*****************************************************************************************************************************************************
*****************************************************************************************************************************************************
*****************************************************************************************************************************************************
*****************************************************************************************************************************************************
*****************************************************************************************************************************************************
*****************************************************************************************************************************************************
*****************************************************************************************************************************************************
*****************************************************************************************************************************************************
*****************************************************************************************************************************************************
*****************************************************************************************************************************************************
*****************************************************************************************************************************************************
*****************************************************************************************************************************************************
W****************************************************************************************************************************************************
W****************************************************************************************************************************************************
W****************************************************************************************************************************************************
W****************************************************************************************************************************************************
W**********G***GGG***********************************************************************************************************************************
W****FRF***U***UUUG**********C***********************************************************************************************************************
UGGGGGGGGGGU***UUUUG***GGGGGGGGGGGG*******GGGGGGGGGGGGGGGGGGGGGGGGGGGGGGGGGGGGGGGGGGGGGGGG***********************************************************
UUUUUUUUUUUU***UUUUU***UUUUUUUUUUUU*******UUUUUUUUUUUUUUUUUUUUUUUUUUUUUUUUUUUUUUUUUUUUUUUUUUUUUUUUUUUUUUUUUUUUUUUUUUUUUUUUUUUUUUUUUUUUUUUU***********
UUUUUUUUUUUU***UUUUUUUUUUUUUUUUUUUU*******UUUUUUUUUUUUUUUUUUUUUUUUUUUUUUUUUUUUUUUUUUUUUUUUUUUUUUUUUUUUUUUUUUUUUUUUUUUUUUUUUUUUUUUUUUUUUUUU***********
UUUUUUUUUUUU***UUUUUUUUUUUUUUUUUUUU*******UUUUUUUUUUUUUUUUUUUUUUUUUUUUUUUUUUUUUUUUUUUUUUUUUUUUUUUUUUUUUUUUUUUUUUUUUUUUUUUUUUUUUUUUUUUUUUUU***********
UUUUUUUUUUUU***UUUUUUUUUUUUUUUUUUUU*******UUUUUUUUUUUUUUUUUUUUUUUUUUUUUUUUUUUUUUUUUUUUUUUUUUUUUUUUUUUUUUUUUUUUUUUUUUUUUUUUUUUUUUUUUUUUUUUU***********
UUUUUUUUUUUU***UUUUUUUUUUUUUUUUUUUU*******UUUUUUUUUUUUUUUUUUUUUUUUUUUUUUUUUUUUUUUUUUUUUUUUUUUUUUUUUUUUUUUUUUUUUUUUUUUUUUUUUUUUUUUUUUUUUUUU***********
UUUUUUUUUUUU***UUUUUUUUUUUUUUUUUUUU*******UUUUUUUUUUUUUUUUUUUUUUUUUUUUUUUUUUUUUUUUUUUUUUUUUUUUUUUUUUUUUUUUUUUUUUUUUUUUUUUUUUUUUUUUUUUUUUUU***********
UUUUUUUUUUUU***UUUUUUUUUUUUUUUUUUUU*******UUUUUUUUUUUUUUUUUUUUUUUUUUUUUUUUUUUUUUUUUUUUUUUUUUUUUUUUUUUUUUUUUUUUUUUUUUUUUUUUUUUUUUUUUUUUUUUU***********
UUUUUUUUUUUU***UUUUUUUUUUUUUUUUUUUU*******UUUUUUUUUUUUUUUUUUUUUUUUUUUUUUUUUUUUUUUUUUUUUUUUUUUUUUUUUUUUUUUUUUUUUUUUUUUUUUUUUUUUUUUUUUUUUUUU***********
UUUUUUUUUUUU***UUUUUUUUUUUUUUUUUUUU*******UUUUUUUUUUUUUUUUUUUUUUUUUUUUUUUUUUUUUUUUUUUUUUUUUUUUUUUUUUUUUUUUUUUUUUUUUUUUUUUUUUUUUUUUUUUUUUUU***********
UUUUUUUUUUUU***UUUUUUUUUUUUUUUUUUUU*******UUUUUUUUUUUUUUUUUUUUUUUUUUUUUUUUUUUUUUUUUUUUUUUUUUUUUUUUUUUUUUUUUUUUUUUUUUUUUUUUUUUUUUUUUUUUUUUU***********
UUUUUUUUUUUU***UUUUUUUUUUUUUUUUUUUU*******UUUUUUUUUUUUUUUUUUUUUUUUUUUUUUUUUUUUUUUUUUUUUUUUUUUUUUUUUUUUUUUUUUUUUUUUUUUUUUUUUUUUUUUUUUUUUUUU***********
UUUUUUUUUUUU***UUUUUUUUUUUUUUUUUUUU*******UUUUUUUUUUUUUUUUUUUUUUUUUUUUUUUUUUUUUUUUUUUUUUUUUUUUUUUUUUUUUUUUUUUUUUUUUUUUUUUUUUUUUUUUUUUUUUUU***********
UUUUUUUUUUUU***UUUUUUUUUUUUUUUUUUUU*******UUUUUUUUUUUUUUUUUUUUUUUUUUUUUUUUUUUUUUUUUUUUUUUUUUUUUUUUUUUUUUUUUUUUUUUUUUUUUUUUUUUUUUUUUUUUUUUU***********
UUUUUUUUUUUU***UUUUUUUUUUUUUUUUUUUU*******UUUUUUUUUUUUUUUUUUUUUUUUUUUUUUUUUUUUUUUUUUUUUUUUUUUUUUUUUUUUUUUUUUUUUUUUUUUUUUUUUUUUUUUUUUUUUUUU***********
UUUUUUUUUUUU***UUUUUUUUUUUUUUUUUUUU*******UUUUUUUUUUUUUUUUUUUUUUUUUUUUUUUUUUUUUUUUUUUUUUUUUUUUUUUUUUUUUUUUUUUUUUUUUUUUUUUUUUUUUUUUUUUUUUUU***********
UUUUUUUUUUUU***UUUUUUUUUUUUUUUUUUUU*******UUUUUUUUUUUUUUUUUUUUUUUUUUUUUUUUUUUUUUUUUUUUUUUUUUUUUUUUUUUUUUUUUUUUUUUUUUUUUUUUUUUUUUUUUUUUUUUU***********
UUUUUUUUUUUU***UUUUUUUUUUUUUUUUUUUU*******UUUUUUUUUUUUUUUUUUUUUUUUUUUUUUUUUUUUUUUUUUUUUUUUUUUUUUUUUUUUUUUUUUUUUUUUUUUUUUUUUUUUUUUUUUUUUUUU***********
UUUUUUUUUUUU***UUUUUUUUUUUUUUUUUUUU*******UUUUUUUUUUUUUUUUUUUUUUUUUUUUUUUUUUUUUUUUUUUUUUUUUUUUUUUUUUUUUUUUUUUUUUUUUUUUUUUUUUUUUUUUUUUUUUUU***********
UUUUUUUUUUUUUUUUUUUUUUUUUUUUUUUUUUUUUUUUUUUUUUUUUUUUUUUUUUUUUUUUUUUUUUUUUUUUUUUUUUUUUUUUUUUUUUUUUUUUUUUUUUUUUUUUUUUUUUUUUUUUUUUUUUUUUUUUUU***********