*****************************************************************************************************************************************************
*****************************************************************************************************************************************************
*****************************************************************************************************************************************************
*****************************************************************************************************************************************************
*****************************************************************************************************************************************************
*****************************************************************************************************************************************************
*****************************************************************************************************************************************************
*****************************************************************************************************************************************************
*****************************************************************************************************************************************************
*****************************************************************************************************************************************************
*****************************************************************************************************************************************************
*****************************************************************************************************************************************************
*****************************************************************************************************************************************************
*****************************************************************************************************************************************************
*****************************************************************************************************************************************************
*****************************************************************************************************************************************************
*****************************************************************************************************************************************************
*****************************************************************************************************************************************************
*****************************************************************************************************************************************************
*****************************************************************************************************************************************************
*****************************************************************************************************************************************************
*****************************************************************************************************************************************************
*****************************************************************************************************************************************************
*****************************************************************************************************************************************************
*****************************************************************************************************************************************************
*****************************************************************************************************************************************************
*****************************************************************************************************************************************************
*****************************************************************************************************************************************************
*****************************************************************************************************************************************************
*****************************************************************************************************************************************************
*****************************************************************************************************************************************************
*****************************************************************************************************************************************************
*****************************************************************************************************************************************************
*****************************************************************************************************************************************************
*****************************************************************************************************************************************************
*****************************************************************************************************************************************************
*****************************************************************************************************************************************************
W****************************************************************************************************************************************************
W****************************************************************************************************************************************************
W****************************************************************************************************************************************************
W****************************************************************************************************************************************************
W**********G***GGG***********************************************************************************************************************************
W****FRF***U***UUUG**********C***********************************************************************************************************************
UGGGGGGGGGGU***UUUUG***GGGGGGGGGGGG*******GGGGGGGGGGGGGGGGGGGGGGGGGGGGGGGGGGGGGGGGGGGGGGGG***********************************************************
UUUUUUUUUUUU***UUUUU***UUUUUUUUUUUU*******UUUUUUUUUUUUUUUUUUUUUUUUUUUUUUUUUUUUUUUUUUUUUUUU***********************************************************
UUUUUUUUUUUU***UUUUUUUUUUUUUUUUUUUU*******UUUUUUUUUUUUUUUUUUUUUUUUUUUUUUUUUUUUUUUUUUUUUUUU***********************************************************
UUUUUUUUUUUU***UUUUUUUUUUUUUUUUUUUU*******UUUUUUUUUUUUUUUUUUUUUUUUUUUUUUUUUUUUUUUUUUUUUUUU***********************************************************
UUUUUUUUUUUU***UUUUUUUUUUUUUUUUUUUU*******UUUUUUUUUUUUUUUUUUUUUUUUUUUUUUUUUUUUUUUUUUUUUUUU***********************************************************
UUUUUUUUUUUU***UUUUUUUUUUUUUUUUUUUU*******UUUUUUUUUUUUUUUUUUUUUUUUUUUUUUUUUUUUUUUUUUUUUUUU***********************************************************
UUUUUUUUUUUU***UUUUUUUUUUUUUUUUUUUU*******UUUUUUUUUUUUUUUUUUUUUUUUUUUUUUUUUUUUUUUUUUUUUUUU***********************************************************
UUUUUUUUUUUU***UUUUUUUUUUUUUUUUUUUU*******UUUUUUUUUUUUUUUUUUUUUUUUUUUUUUUUUUUUUUUUUUUUUUUU***********************************************************
UUUUUUUUUUUU***UUUUUUUUUUUUUUUUUUUU*******UUUUUUUUUUUUUUUUUUUUUUUUUUUUUUUUUUUUUUUUUUUUUUUU***********************************************************
UUUUUUUUUUUU***UUUUUUUUUUUUUUUUUUUU*******UUUUUUUUUUUUUUUUUUUUUUUUUUUUUUUUUUUUUUUUUUUUUUUU***********************************************************
UUUUUUUUUUUU***UUUUUUUUUUUUUUUUUUUU*******UUUUUUUUUUUUUUUUUUUUUUUUUUUUUUUUUUUUUUUUUUUUUUUU***********************************************************
UUUUUUUUUUUU***UUUUUUUUUUUUUUUUUUUU*******UUUUUUUUUUUUUUUUUUUUUUUUUUUUUUUUUUUUUUUUUUUUUUUU***********************************************************
UUUUUUUUUUUU***UUUUUUUUUUUUUUUUUUUU*******UUUUUUUUUUUUUUUUUUUUUUUUUUUUUUUUUUUUUUUUUUUUUUUU***********************************************************
UUUUUUUUUUUU***UUUUUUUUUUUUUUUUUUUU*******UUUUUUUUUUUUUUUUUUUUUUUUUUUUUUUUUUUUUUUUUUUUUUUU***********************************************************
UUUUUUUUUUUU***UUUUUUUUUUUUUUUUUUUU*******UUUUUUUUUUUUUUUUUUUUUUUUUUUUUUUUUUUUUUUUUUUUUUUU***********************************************************
UUUUUUUUUUUU***UUUUUUUUUUUUUUUUUUUU*******UUUUUUUUUUUUUUUUUUUUUUUUUUUUUUUUUUUUUUUUUUUUUUUU***********************************************************
UUUUUUUUUUUU***UUUUUUUUUUUUUUUUUUUU*******UUUUUUUUUUUUUUUUUUUUUUUUUUUUUUUUUUUUUUUUUUUUUUUU***********************************************************
UUUUUUUUUUUU***UUUUUUUUUUUUUUUUUUUU*******UUUUUUUUUUUUUUUUUUUUUUUUUUUUUUUUUUUUUUUUUUUUUUUU***********************************************************
UUUUUUUUUUUU***UUUUUUUUUUUUUUUUUUUU*******UUUUUUUUUUUUUUUUUUUUUUUUUUUUUUUUUUUUUUUUUUUUUUUU***********************************************************
UUUUUUUUUUUUUUUUUUUUUUUUUUUUUUUUUUUUUUUUUUUUUUUUUUUUUUUUUUUUUUUUUUUUUUUUUUUUUUUUUUUUUUUUUU***********************************************************