*****************************************************************************************************************************************************
*****************************************************************************************************************************************************
*****************************************************************************************************************************************************
*****************************************************************************************************************************************************
*****************************************************************************************************************************************************
*****************************************************************************************************************************************************
*****************************************************************************************************************************************************
*****************************************************************************************************************************************************
*****************************************************************************************************************************************************
*****************************************************************************************************************************************************
*****************************************************************************************************************************************************
*****************************************************************************************************************************************************
*****************************************************************************************************************************************************
*****************************************************************************************************************************************************
*****************************************************************************************************************************************************
*****************************************************************************************************************************************************
*****************************************************************************************************************************************************
*****************************************************************************************************************************************************
*****************************************************************************************************************************************************
*****************************************************************************************************************************************************
*****************************************************************************************************************************************************
*****************************************************************************************************************************************************
*****************************************************************************************************************************************************
*****************************************************************************************************************************************************
*****************************************************************************************************************************************************
*****************************************************************************************************************************************************
*****************************************************************************************************************************************************
*****************************************************************************************************************************************************
*****************************************************************************************************************************************************
*****************************************************************************************************************************************************
*****************************************************************************************************************************************************
*****************************************************************************************************************************************************
*****************************************************************************************************************************************************
*****************************************************************************************************************************************************
*****************************************************************************************************************************************************
*****************************************************************************************************************************************************
*****************************************************************************************************************************************************
W****************************************************************************************************************************************************
W****************************************************************************************************************************************************
W****************************************************************************************************************************************************
W****************************************************************************************************************************************************
W**********G***GGG***********************************************************************************************************************************
W****FRF***U***UUUG**********C***********************************************************************************************************************
UGGGGGGGGGGUHHHUUUUGHHHGGGGGGGGGGGG*******GGGGGGGGGGGGGGGGGGGGGGGGGGGGGGGGGGGGGGGGGGGGGGGG***********************************************************
UUUUUUUUUUUUHHHUUUUUHHHUUUUUUUUUUUU*******UUUUUUUUUUUUUUUUUUUUUUUUUUUUUUUUUUUUUUUUUUUUUUUUUUUUUUUUUUUUUUUUUUUUUUUUUUUUUUUUUUUUUUUUUUUUUUUU***********
UUUUUUUUUUUUHHHUUUUUUUUUUUUUUUUUUUU*******UUUUUUUUUUUUUUUUUUUUUUUUUUUUUUUUUUUUUUUUUUUUUUUUUUUUUUUUUUUUUUUUUUUUUUUUUUUUUUUUUUUUUUUUUUUUUUUU***********
UUUUUUUUUUUUHHHUUUUUUUUUUUUUUUUUUUU*******UUUUUUUUUUUUUUUUUUUUUUUUUUUUUUUUUUUUUUUUUUUUUUUUUUUUUUUUUUUUUUUUUUUUUUUUUUUUUUUUUUUUUUUUUUUUUUUU***********
UUUUUUUUUUUUHHHUUUUUUUUUUUUUUUUUUUU*******UUUUUUUUUUUUUUUUUUUUUUUUUUUUUUUUUUUUUUUUUUUUUUUUUUUUUUUUUUUUUUUUUUUUUUUUUUUUUUUUUUUUUUUUUUUUUUUU***********
UUUUUUUUUUUU***UUUUUUUUUUUUUUUUUUUU*******UUUUUUUUUUUUUUUUUUUUUUUUUUUUUUUUUUUUUUUUUUUUUUUUUUUUUUUUUUUUUUUUUUUUUUUUUUUUUUUUUUUUUUUUUUUUUUUU***********
UUUUUUUUUUUU***UUUUUUUUUUUUUUUUUUUU*******UUUUUUUUUUUUUUUUUUUUUUUUUUUUUUUUUUUUUUUUUUUUUUUUUUUUUUUUUUUUUUUUUUUUUUUUUUUUUUUUUUUUUUUUUUUUUUUU***********
UUUUUUUUUUUU***UUUUUUUUUUUUUUUUUUUU*******UUUUUUUUUUUUUUUUUUUUUUUUUUUUUUUUUUUUUUUUUUUUUUUUUUUUUUUUUUUUUUUUUUUUUUUUUUUUUUUUUUUUUUUUUUUUUUUU***********
UUUUUUUUUUUU***UUUUUUUUUUUUUUUUUUUU*******UUUUUUUUUUUUUUUUUUUUUUUUUUUUUUUUUUUUUUUUUUUUUUUUUUUUUUUUUUUUUUUUUUUUUUUUUUUUUUUUUUUUUUUUUUUUUUUU***********
UUUUUUUUUUUU***UUUUUUUUUUUUUUUUUUUU*******UUUUUUUUUUUUUUUUUUUUUUUUUUUUUUUUUUUUUUUUUUUUUUUUUUUUUUUUUUUUUUUUUUUUUUUUUUUUUUUUUUUUUUUUUUUUUUUU***********
UUUUUUUUUUUU***UUUUUUUUUUUUUUUUUUUU*******UUUUUUUUUUUUUUUUUUUUUUUUUUUUUUUUUUUUUUUUUUUUUUUUUUUUUUUUUUUUUUUUUUUUUUUUUUUUUUUUUUUUUUUUUUUUUUUU***********
UUUUUUUUUUUU***UUUUUUUUUUUUUUUUUUUU*******UUUUUUUUUUUUUUUUUUUUUUUUUUUUUUUUUUUUUUUUUUUUUUUUUUUUUUUUUUUUUUUUUUUUUUUUUUUUUUUUUUUUUUUUUUUUUUUU***********
UUUUUUUUUUUU***UUUUUUUUUUUUUUUUUUUU*******UUUUUUUUUUUUUUUUUUUUUUUUUUUUUUUUUUUUUUUUUUUUUUUUUUUUUUUUUUUUUUUUUUUUUUUUUUUUUUUUUUUUUUUUUUUUUUUU***********
UUUUUUUUUUUU***UUUUUUUUUUUUUUUUUUUU*******UUUUUUUUUUUUUUUUUUUUUUUUUUUUUUUUUUUUUUUUUUUUUUUUUUUUUUUUUUUUUUUUUUUUUUUUUUUUUUUUUUUUUUUUUUUUUUUU***********
UUUUUUUUUUUU***UUUUUUUUUUUUUUUUUUUU*******UUUUUUUUUUUUUUUUUUUUUUUUUUUUUUUUUUUUUUUUUUUUUUUUUUUUUUUUUUUUUUUUUUUUUUUUUUUUUUUUUUUUUUUUUUUUUUUU***********
UUUUUUUUUUUU***UUUUUUUUUUUUUUUUUUUU*******UUUUUUUUUUUUUUUUUUUUUUUUUUUUUUUUUUUUUUUUUUUUUUUUUUUUUUUUUUUUUUUUUUUUUUUUUUUUUUUUUUUUUUUUUUUUUUUU***********
UUUUUUUUUUUU***UUUUUUUUUUUUUUUUUUUU*******UUUUUUUUUUUUUUUUUUUUUUUUUUUUUUUUUUUUUUUUUUUUUUUUUUUUUUUUUUUUUUUUUUUUUUUUUUUUUUUUUUUUUUUUUUUUUUUU***********
UUUUUUUUUUUU***UUUUUUUUUUUUUUUUUUUU*******UUUUUUUUUUUUUUUUUUUUUUUUUUUUUUUUUUUUUUUUUUUUUUUUUUUUUUUUUUUUUUUUUUUUUUUUUUUUUUUUUUUUUUUUUUUUUUUU***********
UUUUUUUUUUUU***UUUUUUUUUUUUUUUUUUUU*******UUUUUUUUUUUUUUUUUUUUUUUUUUUUUUUUUUUUUUUUUUUUUUUUUUUUUUUUUUUUUUUUUUUUUUUUUUUUUUUUUUUUUUUUUUUUUUUU***********
UUUUUUUUUUUUUUUUUUUUUUUUUUUUUUUUUUUUUUUUUUUUUUUUUUUUUUUUUUUUUUUUUUUUUUUUUUUUUUUUUUUUUUUUUUUUUUUUUUUUUUUUUUUUUUUUUUUUUUUUUUUUUUUUUUUUUUUUUU***********